{
  "⺥": "爫",
  "⺻": "聿",
  "⼙": "卩",
  "⽼": "老",
  "⺗": "心",
  "⺧": "牛",
  "⼜": "又",
  "⼴": "广",
  "⾪": "隶",
  "⾲": "韭",
  "⺠": "民",
  "⼂": "丶",
  "⾀": "聿",
  "⾸": "首",
  "⿀": "鬲",
  "⼁": "丨",
  "⽆": "无",
  "⽡": "瓦",
  "⾁": "肉",
  "⾉": "艮",
  "⾤": "釆",
  "⺕": "彐",
  "⼉": "儿",
  "⼗": "十",
  "⾇": "舛",
  "⾓": "角",
  "⺅": "亻",
  "⺨": "犭",
  "⼇": "亠",
  "⼩": "小",
  "⽏": "毋",
  "⽦": "疋",
  "㇜": "𠃋",
  "⺍": "小",
  "⾦": "金",
  "⿎": "鼓",
  "㇓": "丿",
  "㇕": "𠃍",
  "⼀": "一",
  "⽖": "爪",
  "⽺": "羊",
  "⾒": "見",
  "㇘": "𠃎",
  "⻅": "见",
  "⻈": "讠",
  "⻜": "飞",
  "⻭": "歯",
  "⻰": "龙",
  "⼿": "手",
  "⽴": "立",
  "⿁": "鬼",
  "⺾": "艹",
  "⿂": "魚",
  "⼅": "亅",
  "⾖": "豆",
  "⿇": "麻",
  "⻧": "卤",
  "⻑": "長",
  "⼎": "冫",
  "⼯": "工",
  "⽁": "攴",
  "⽘": "爻",
  "⿃": "鳥",
  "⺘": "扌",
  "⿋": "黹",
  "⽞": "玄",
  "⺮": "𥫗",
  "⻆": "角",
  "⻗": "雨",
  "⺫": "目",
  "⻄": "西",
  "⽫": "皿",
  "⾜": "足",
  "⿆": "麥",
  "⺯": "糹",
  "⻠": "饣",
  "⼝": "口",
  "⽢": "甘",
  "⽲": "禾",
  "⾔": "言",
  "㇖": "乛",
  "⺩": "王",
  "⺓": "幺",
  "⺴": "冗",
  "⻏": "邑",
  "⼱": "巾",
  "⽨": "癶",
  "⺇": "𠘨",
  "⺝": "月",
  "⼥": "女",
  "⾑": "襾",
  "⾧": "長",
  "⿉": "黍",
  "㇒": "丿",
  "⺑": "𡯂",
  "⻯": "竜",
  "⼔": "匕",
  "⼬": "屮",
  "⾬": "雨",
  "⾼": "高",
  "⿐": "鼻",
  "㇗": "𠃊",
  "⺞": "歺",
  "⼆": "二",
  "⼳": "幺",
  "⽗": "父",
  "⽮": "矢",
  "⿕": "龠",
  "㇠": "乙",
  "⻓": "长",
  "⺢": "氺",
  "⻎": "辶",
  "⻞": "𩙿",
  "⼖": "匸",
  "⽧": "疒",
  "⾣": "酉",
  "⿒": "齒",
  "⺎": "兀",
  "㇞": "𠃑",
  "⽂": "文",
  "⽵": "竹",
  "⽽": "而",
  "⾹": "香",
  "㇚": "亅",
  "⽀": "支",
  "⻍": "辶",
  "⻫": "斉",
  "⽜": "牛",
  "㇟": "乚",
  "⺜": "日",
  "⼤": "大",
  "⼰": "己",
  "⾻": "骨",
  "⿑": "齊",
  "⺉": "刂",
  "⺔": "彑",
  "⺷": "𦍌",
  "⺼": "肉",
  "⼪": "尢",
  "⿈": "黃",
  "⿏": "鼠",
  "⿔": "龜",
  "⺋": "㔾",
  "⺰": "纟",
  "⻌": "辶",
  "⼞": "囗",
  "⼶": "廾",
  "⽰": "示",
  "⿍": "鼎",
  "⺭": "礻",
  "⼛": "厶",
  "⼃": "丿",
  "⺬": "示",
  "⻙": "韦",
  "⻤": "鬼",
  "⾰": "革",
  "⺏": "尣",
  "⺐": "尢",
  "⽙": "爿",
  "⽚": "片",
  "⽛": "牙",
  "⾘": "豸",
  "⾫": "隹",
  "⾿": "鬯",
  "⺃": "乚",
  "㇝": "乀",
  "⼐": "凵",
  "⼨": "寸",
  "⽈": "曰",
  "⽉": "月",
  "⽾": "耒",
  "⺽": "𦥑",
  "⼒": "力",
  "⽌": "止",
  "⽍": "歹",
  "⽪": "皮",
  "⽸": "缶",
  "⾍": "虫",
  "⼄": "乙",
  "⻮": "齿",
  "⼊": "入",
  "⼢": "夊",
  "⼣": "夕",
  "⼦": "子",
  "⽊": "木",
  "⽤": "用",
  "⻁": "虎",
  "⾳": "音",
  "⽩": "白",
  "⻒": "镸",
  "⾮": "非",
  "㇔": "丶",
  "⺆": "冂",
  "⼟": "土",
  "⽣": "生",
  "⽷": "糸",
  "⿅": "鹿",
  "⻣": "骨",
  "⺹": "耂",
  "⼽": "戈",
  "⾎": "血",
  "⾺": "馬",
  "㇏": "乀",
  "⺊": "卜",
  "⼫": "尸",
  "⽠": "瓜",
  "⼓": "勹",
  "⺖": "忄",
  "⽯": "石",
  "⽶": "米",
  "㇆": "𠃌",
  "㇑": "丨",
  "⺄": "乙",
  "⼏": "几",
  "⽝": "犬",
  "⾃": "自",
  "⾠": "辰",
  "⺱": "罓",
  "⽔": "水",
  "⺤": "爫",
  "⻝": "食",
  "⻪": "黾",
  "⽃": "斗",
  "⽅": "方",
  "⽹": "网",
  "⽻": "羽",
  "⾴": "頁",
  "⻇": "𧢲",
  "⼘": "卜",
  "⼠": "士",
  "⼡": "夂",
  "⼼": "心",
  "⾗": "豕",
  "⻕": "𨸏",
  "⾄": "至",
  "⾞": "車",
  "⼾": "戶",
  "⽓": "气",
  "⿄": "鹵",
  "⼲": "干",
  "⼹": "彐",
  "⽕": "火",
  "⾛": "走",
  "⺙": "攵",
  "⻊": "𧾷",
  "⻖": "阝",
  "⻡": "𩠐",
  "⼸": "弓",
  "⽿": "耳",
  "⺪": "𤴔",
  "⽇": "日",
  "⽎": "殳",
  "⽱": "禸",
  "⾵": "風",
  "⻋": "车",
  "⼑": "刀",
  "⽬": "目",
  "⺌": "小",
  "⽑": "毛",
  "⽭": "矛",
  "⾌": "虍",
  "⼭": "山",
  "⼋": "八",
  "⾙": "貝",
  "⻀": "艹",
  "⺶": "羊",
  "⺺": "肀",
  "⻉": "贝",
  "⾈": "舟",
  "⾭": "靑",
  "⾯": "面",
  "⿊": "黑",
  "⺡": "氵",
  "㇡": "𠄎",
  "⿓": "龍",
  "⼷": "弋",
  "⽳": "穴",
  "⾟": "辛",
  "⺣": "灬",
  "⽟": "玉",
  "⾶": "飛",
  "⿌": "黽",
  "⺲": "罒",
  "⺵": "𦉫",
  "⻂": "衤",
  "⻦": "鸟",
  "⼌": "冂",
  "⼻": "彳",
  "⾋": "艸",
  "⺂": "乛",
  "⾆": "舌",
  "⾝": "身",
  "⾱": "韋",
  "⺿": "艹",
  "⻨": "麦",
  "⻬": "齐",
  "⼈": "人",
  "⼮": "巛",
  "⾂": "臣",
  "㇛": "𡿨",
  "⺒": "巳",
  "⺳": "㓁",
  "⾨": "門",
  "⺟": "母",
  "⺦": "丬",
  "⻐": "钅",
  "⾾": "鬥",
  "⺛": "旡",
  "⺸": "𦍋",
  "⻢": "马",
  "⻩": "黄",
  "⼍": "冖",
  "⺁": "厂",
  "⻛": "风",
  "⻟": "飠",
  "⻲": "亀",
  "⻳": "龟",
  "⼕": "匚",
  "⼵": "廴",
  "⾊": "色",
  "⻘": "青",
  "⾽": "髟",
  "㇐": "一",
  "⻃": "覀",
  "⼺": "彡",
  "⾏": "行",
  "⾕": "谷",
  "⾩": "阜",
  "㇙": "𠄌",
  "⻥": "鱼",
  "⼚": "厂",
  "⽄": "斤",
  "⽋": "欠",
  "⾅": "臼",
  "⾥": "里",
  "⺈": "刀",
  "⼧": "宀",
  "⽒": "氏",
  "⾐": "衣",
  "⾚": "赤",
  "⾡": "辵",
  "⾢": "邑",
  "⻱": "龜",
  "⻚": "页",
  "⽐": "比",
  "⽥": "田",
  "⾷": "食",
  "⻔": "门",
  "ｪ": "工",
  "ェ": "工",
  "ｴ": "工",
  "ｫ": "才",
  "ォ": "才",
  "ｵ": "オ",
  "ｰ": "一",
  "ー": "一",
  "㆜": "丁",
  "㆔": "三",
  "㆖": "上",
  "㆘": "下",
  "㆛": "丙",
  "㆗": "中",
  "〹": "卄",
  "㆕": "四",
  "㆞": "地",
  "㆝": "天",
  "㆙": "甲"
}